


NO ./textures/north.png


            SO ./textures/south.png

WE ./textures/west.png
      EA ./textures/east.png

  F                         255,100,0
  C                                                     255,0,0

11111
10000111111
 10000000001
  10000000001
  11111111111

  111111111
   1000000011111
   1000000000001
   10000N0010001
   1000000010001
   100000010001
   1111111111111
