


NO ./rscs/textures/wall/north.png


            SO ./rscs/textures/wall/south.png

WE ./rscs/textures/wall/west.png
      EA ./rscs/textures/wall/east.png

  F                         255,100,0
  C                                                     255,0,0


1111111111
11000000001            111
1 111111101            1W1
1        101           111
11111 11111
10001 100001
10001 100001
100011100001
100001000001
100000000003
100000000001
100000000001
100000000001
100000000001
100000000001
111111111111
