NO ./rscs/textures/wall/north.png
SO ./rscs/textures/wall/south.png
WE ./rscs/textures/wall/west.png
EA ./rscs/textures/wall/east.png

F 255,100,0
C 255,0,0

11111
10000111111
 10000000001
  10000000001
   1000000011111
   1000000000001
   1000000010001
   1000000010001
   10000NN0010001
   1111111111111
