


NO ./rscs/textures/wall/invalid.png


                       SO ./rscs/textures/wall/south.png

WE ./rscs/textures/wall/west.png
      EA ./rscs/textures/wall/east.png

  F                         255,100,0
  C                                                     255,0,0




11111111111111111111
100000000000000E0001
10000000000111111111
100000000001
100000000001
100000000001
100000000001
100000000001
100000000001
100000000001
100000000001
100000000001
100000000001
100000000001
100000000001
111111111111
