



NO ./rscs/textures/wall/cobblestone.png


            SO ./rscs/textures/wall/cobblestone.png

WE ./rscs/textures/wall/grass.png
      EA ./rscs/textures/wall/grass.png

  F                         255,100,0
  C                                                     255,0,0


 1111111111
10S01
10001
10001
11311
10001
 10001111111
  100000000011
   100000000001111111
   1000000000010000001
   1000000000020000001
   1000000000010000001
   100000000001111111
   10000000111
  100000111
 1000011
111111
